

SO     textures/crate1.xpm

NO textures/window.xpm
EA textures/vent1.xpm


WE textures/wall1.xpm

F 20,20,20
C   255,30,0


1111111111
1000000001
1000000001
1000000001
1000000001
1000000001
1000000001
1000000001
10000N0001
1111111111
