F 139,99,58

NO textures/simonkraft/bookshelf.xpm
SO textures/simonkraft/bookshelf_01.xpm
C 171,154,137
WE textures/simonkraft/bookshelf_02.xpm
EA textures/simonkraft/bookshelf_03.xpm


1111111111111111111
1001001001010001001
1001001001001001001
1001001001001001001
1001001000001001001
100000000S000000001
1000011111111011111
1111000000000001111
1000000101010000001
1111111111111111111
