


F                                  0,0,0
C                          255,              0,0


NO textures/simonkraft/wet_sponge.xpm
SO textures/simonkraft/wet_sponge.xpm
WE textures/simonkraft/wet_sponge.xpm
EA textures/simonkraft/wet_sponge.xpm


11111111111    11
1N0011110001 1111
1 01   10001  101
 111    111111111
