NO textures/test/north.xpm

SO textures/test/south.xpm
WE textures/test/west.xpm
EA textures/test/east.xpm

F 20,20,20
C 200,200,200

111111111111111111111
100000000100000000001
 100001111111100000001
100001000000100000001
1000010000N0100000001
111111111111111111111
1100011111111100000001
1 111111111111111111111111111111111111111111111111111