111111111111111111111111
100000000000000000000001
100000000000000000000001
100000000000000000000001
100000222220000303030001
100000200020000000000001
100000200020000300030001
100000200020000000000001
100000220220000303030001
100000000000000000000001
100444444000000000000001
100400004000000000000001
100000P04000000000000001
100400004000000000000001
100444444000000000000001
100000000000000000000001
100000000000000000000001
111111111111111111111111